░█████████░░▓▓▓▓▓
░░░█████░░░░░▓▓▓▓
█░░░░░░░▓▓▓░░░░▓▓
██░░░░░▓▓▓▓▓░░░░░
███░░▓▓▓▓▓▓▓▓░░░░
▒▒▒░░░░░░▓▓▓░░░░░
▒▒▒▒░░░░░░░░░▒▒▒▒
███░░░░░░░░░▒▒▒▒▒
██░░░░░░░░░░░░▒▒▒
░░░░░░░░░░░░░░▓▓▓
▓▓▒▒▒░░░░░░░░▓▓▓▓
▓▓▓▒▒▒░░░░░░░░▓▓▓
▓▓▓▓▒▒▒░░░░░░░░▓▓