▓▓▓░░████░░░█████
░▓░░██▒█░░░░░███░
█░░░█▒▒█░░░░░██░░
██░░█▒▒███░░░░░░░
███░██▒▒▒█░░░░░░░
▒▒▒░░███▒█░░░░░░░
▒▒▒▒░░████░░░░▒▒▒
███░░░░██░░░░░▒▒▒
██░░░░░░█░░░░░▒▒▓
▓█░░░░░░░░░░░░▓▓▓
▓▓░░░░░░░░░░░▓▓▓▓
▓▓▓░░░░░░░░░░░▓▓▓
▓▓▓▓░░░░░░░░░░░▓▓