░░██████████████████░░░░▓▓▓▓▓▓▓▓
░░██████████████████░░░░▓▓▓▓▓▓▓▓
░░░░░░██████████░░░░░░░░░░▓▓▓▓▓▓
░░░░░░██████████░░░░░░░░░░▓▓▓▓▓▓
██░░░░░░░░░░░░░░▓▓▓▓▓▓░░░░░░░░▓▓
██░░░░░░░░░░░░░░▓▓▓▓▓▓░░░░░░░░▓▓
████░░░░░░░░░░▓▓▓▓▓▓▓▓▓▓░░░░░░░░
████░░░░░░░░░░▓▓▓▓▓▓▓▓▓▓░░░░░░░░
██████░░░░▓▓▓▓▓▓▓▓▓▓▓▓▓▓▓▓░░░░░░
██████░░░░▓▓▓▓▓▓▓▓▓▓▓▓▓▓▓▓░░░░░░
▒▒▒▒▒▒░░░░░░░░░░░░▓▓▓▓▓▓░░░░░░░░
▒▒▒▒▒▒░░░░░░░░░░░░▓▓▓▓▓▓░░░░░░░░
▒▒▒▒▒▒▒▒░░░░░░░░░░░░░░░░░░▒▒▒▒▒▒
▒▒▒▒▒▒▒▒░░░░░░░░░░░░░░░░░░▒▒▒▒▒▒
██████░░░░░░░░░░░░░░░░░░▒▒▒▒▒▒▒▒
██████░░░░░░░░░░░░░░░░░░▒▒▒▒▒▒▒▒
████░░░░░░░░░░░░░░░░░░░░░░░░▒▒▒▒
████░░░░░░░░░░░░░░░░░░░░░░░░▒▒▒▒
░░░░░░░░░░░░░░░░░░░░░░░░░░░░▓▓▓▓
░░░░░░░░░░░░░░░░░░░░░░░░░░░░▓▓▓▓
▓▓▓▓▒▒▒▒▒▒░░░░░░░░░░░░░░░░▓▓▓▓▓▓
▓▓▓▓▒▒▒▒▒▒░░░░░░░░░░░░░░░░▓▓▓▓▓▓
▓▓▓▓▓▓▒▒▒▒▒▒░░░░░░░░░░░░░░░░▓▓▓▓
▓▓▓▓▓▓▒▒▒▒▒▒░░░░░░░░░░░░░░░░▓▓▓▓
▓▓▓▓▓▓▓▓▒▒▒▒▒▒░░░░░░░░░░░░░░░░▓▓
▓▓▓▓▓▓▓▓▒▒▒▒▒▒░░░░░░░░░░░░░░░░▓▓